+---+---+---+---+
        |       |
+   +---+   +   +
|       |   |   |
+---+   +---+   +
|   |           |
+---+   +---+   +
|   |   |   |    
+---+---+---+---+
